....................
....................
..........X.........
.......######.......
...................
####.............###
....................
......--------......
...--...........--..
....................
....................
####............####
....................
.1..................
####################
